5 15
|-------------|
|...|-|.....F.|
|...|.@.......|
|F........|...|
|-------------|